Ангел. фізік|Румфорд
Ангел. фізік|Тиндаль
Ангел. цэнтральная нядзельная газета|обсервер
Ангел. шахматыст|Блекберн
Ангельская дынастыя|Виндзор
Ангельская манета|шылінг
Ангельскі акцёр па імі Піцер, з рускім прозвішчам|Усцінаў
Ангельскі матэматык, логік і філосаф (1922–74)|Лакатос
Ангельскі вандроўца, які наведаў Маскоўская дзяржава і што пакінуў запісы пра яго|Ченслер
Ангельскі пісьменнік, лаўрэат Нобелеўскай прэміі па літаратуры, аўтар шматлікіх папулярных дзіцячых твораў|Киплинг
Ангельскі пісьменнік. Нобелеўская прэмія (1907)|Киплинг
Ангельскі пісьменнік. Нобелеўская прэмія (1983)|Голдинг
Ангельскі фізік, стваральнік класічнай электрадынамікі|Максвел
Ангельскі флатаводзец|Нэльсан
Ангелец, які адкрыў каляровую анамалію зроку|Дальтон
Ангелец, паспелы адкрыць не толькі нутацыю зямной восі, але яшчэ і ў дадаткаў аберацыю святла|Брадлей
Ангелец, за 226 дзён на яхце абмінуў зямны шар|Чичестер
Англія, графства|Дербишир
Англія, графства|Камбрия
Англія, графства|Ланкашир
Англія, графства|Уилтшир
Англія, графства|Уорикшир
Англія, графства|Хемпшир
Англія, графства|Шропшир
Анкета па сваёй сутнасці|апытальнік
Ганна Ахматава прадказала яму хвалебны лёс і цяжкае жыццё. Хто ён?|Бродскі
Антарктычная нялёткая птушка|пінгвін
Антонім авангард|ар'ергард
Антонім сардэчных адносін|нялюбасць
Антонім складзі|разбяры
Антонім падабенства|адрозненне
Антонім змярканне|світанак
Антонім святло|цемра
Антонім рэшта|прыёмка
Антонім сімпатыя|антыпатыя
Антонім слабы|моцны
Антонім смерць|нараджэнне
Антонім знадворку|знутры
Антонім зледзянець|адтаць
Антонім засмучэнне, смутак|радасць
Антонім адгадка|загадка
Антонім адмова|згода
Антонім росквіт|завяданне
Антонім руйнаваць|ствараць
Антонім разбяры|складзі
Антонім гутарка|маўчанне
Антонім адрозненне|падабенства
Антонім рэгрэс|прагрэс
Антонім лаянка|хвала
Антонім лаяцца|мірыцца
Антонім вырадак|прыгажун
Антонім страта|прыбытак
Антонім завяданне|росквіт
Антонім вузкі|шырокі
Антонім караціць|падаўжаць
Антонім паляпшаць|пагаршаць
Антонім розум|утрапёнасць
Антонім бяднець|багацець
Антонім багацце|бедната
Антонім брунет|бландын
Антонім будні|свята
Антонім высакароднасць, сумленнасць|ганебнасць
Антонім успамінаць|забываць
Антонім сустрэча|праводзіны
Антонім воля|бязволле
Антонім уздоўж|папярок
Антонім ганарліва|зняважана
Антонім згуба|выратаванне
Антонім гладка|шурпата
Антонім загадка|адгадка
Антонім зрок|слепата
Антонім імпарт|экспарт
Антонім копія|арыгінал
Антонім купля|продаж
Антонім твар (кравецкае)|выварат
Антонім матэрыяліст|ідэаліст
Антонім маўчанне|гутарка
Антонім імгненне|вечнасць
Антонім наступ|абарона
Антонім апранаць|здымаць
Антонім надзея|роспач
Антонім няволя|воля
Антонім недахоп|лішак
Антонім нікчэмнасць|веліч
Антонім песіміст|аптыміст
Антонім падробка|арыгінал
Антонім падняць|выпусціць
Антонім страта|знаходка
Антонім продак|нашчадак
Антонім талент|няздара
Антонім губляць|знаходзіць
Антонім працавітасць|ленасць
Антонім франтавік|тылавік
Антонім цноты|распуста
Антракт, праведзены з агеньчыкам|перакур
Антракт|заслона
Антыбактэрыйнае рэчыва, якое выдаткоўваецца раслінай|фітанцыд
Антыбіётык|стрэптаміцын
Антыквар па родзе заняткаў|гандляр
Антыкварная бронекамізэлька|кальчуга
Антылопа Паўночнай Амерыкі|віларог
Антиморозко (автомоб.)|антыфрыз
Антыпод аскета|сібарыт
Антыпод блакітнага|натурал
Антычная судьбина|планида
Антычная вершаваная ступня|харыямб
Антычная адзежа|халаміда
Антычная двухколавая калясніца|квадрыга
Антычная кідальная машына|баліста
Антычнае бажаство, заступнік мараплаўцаў|Меликерт
Антычны будынак з калонамі|простиль
Антычны навуковец Страбон|географ
Антычны горад у крыму|Херсонес
Антычны горад на Чорным моры|Гераклея
Апельсінавы марачны лікёр|куантро
Красавік, калі заляцаецца, снежань – калі жэніцца|мужчына
Апарат сувязі|тэлетайп
Апарат у папераробнай вытворчасці|шарошка
Апарат для ажыццяўлення розных фізіка-хімічных працэсаў пад падвышаным ціскам|аўтаклаў
Апарат для разгледжвання слайдаў|диаскоп
Апарат для размнажэння рукапісаў|ротатор
Апарат для выдалення з вінаграднага сусла скуркі і зерняў|дебурбер
Апарат для глыбакаводных апусканняў|батыскаф
Апарат для дыхання пад вадой, які выкарыстоўвае балоны са сціснутым паветрам|акваланг
Апарат для запаволення хуткасці падзення|парашут
Апарат для награвання пад ціскам|аўтаклаў
Апарат для перадачы маўленчай інфармацыі на адлегласць па правадах ці па радыё|тэлефон
Апарат для перадачы і прыёму графічна выкананай інфармацыі ў дакументацыі ў арыгінальным выглядзе сродкамі далёкай сувязі|тэлефакс
Апарат для перасоўвання вадкасцяў, газу ці сыпкіх целаў|эжэктар
Апарат для плавання пад вадой на невялікай глыбіні|акваланг
Апарат для тонкага памолу якіх-небудзь матэрыялаў|млын
Апарат ці ўсталёўка для ажыццяўлення некаторых фізічных ці хімічных працэсаў|рэактар
Апарат, што здзяйсняе абсорбцыю|абсорбер
Апарат, у якім адбываецца паглынанне чаго-небудзь|адсорбер
Апарат, у якім адбываюцца хімічныя, фізічныя, ядзерныя рэакцыі|рэактар
Аптэчны працаўнік з вышэйшай фармацэўтычнай адукацыяй|правізар
Атавізм, перажытак|рэверсія
Атэіст, у якога бракуе адвагі прызнацца ў сваіх поглядах|агностык
Атэізм|бязбожнасць
Атэізм|нявера
Атамныя і малекулярныя хвалевыя функцыі электронаў|орбитали
Атамы аднаго і таго ж хімічнага элемента, якія маюць розныя атамныя вагі|ізатопы
Атамы і малекулы, што маюць неспаренный электрон|радыкал
Атрыбут малюнка Гермеса як бога – заступніка статкаў|ягня
Атрыбут, сімптом|прыкмета
Атлетычнае спаборніцтва ў Старажытнай Грэцыі|агон
Атмасферная з'ява|снегапад
Атмасферны фронт з узыходным рухам цёплага паветра|анафронт
Атмасферны фронт, які характарызуецца ўзыходным рухам цёплага паветра|анафронт
Атракцыён-круцёлка|карусель
Аферыст|ашуканец
Афарызм матэматыка Литтлвуда: “Рэпутацыя матэматыка засноўваецца на ліку дрэнных ... , прыдуманых ім”|доказаў
Афрыкаанс, мова Афрыкі|бурскі
Афрыканская краіна, якая радуе добрым футболам|Камерун
Афрыканская краіна, у курортны бізнэс якой мае намер укласці стромкія бабкі кароль папа Майкл Джэксан|Зімбабвэ
Афрыканская краіна, чый сцяг прыцягвае тых суднаўладальнікаў, якія не кахаюць плаціць падаткі|Ліберыя
Афрыканская разнавіднасць ксилофона|маримба
Афрыканская рака, вядомая нават дзецям з казак Карнея Чуковского|Лимпопо
Афрыканская рака, якую жадаў убачыць Айбаліт|Лимпопо
Афрыканская гадзюка|насарог
Афрыканская жуйная парнакапытная жывёла сямействы полорогих|антылопа
Афрыканская ўдарная музычная прылада тыпу ксилофона|маримба
Афрыканскі народ|туарэгі
Афганістан (горад у Азіі)|Кандагар
Афінскі суд|арэапаг
Афінскі стратэг 5 ст. да н. э.|Алкивиад
Афінскі аратар і публіцыст, які лічыў вучонасць салодкім плёнам горкага кораня|Ісакрат
Афінскі аратар, правадыр антимакедонской групоўкі|Дэмасфен
Афінскі палітычны дзеяч і вайскавод, пляменнік Перикла|Алкивиад
Аэрапорт у Санкт-Пецярбургу|Пулково
Аэрастат на цязе|дырыжабль
Аэрадынамічныя паверхні ў лятальным апараце, што забяспечваюць яго ўстойлівасць і кіравальнасць|апярэнне
Аэрапорт у Стакгольме|Арланда
Аэрапорт у Ерэване|Звартноц
Аэрапорт у Осла|Форнебю
Аэрапорт у Рыме|Чампино
Аэрапорт у Разані|Дягилево
Аэрапорт у Туле|Клоково
Аэрапорт у Цверы|Мигалово
Аэрапорт у Волагдзе|рыбкіна
Аэрапорт ва Ўладзівастоку|кневичи
Аэрапорт у Грозным|ханталы
Аэрапорт у Лісабоне|френкель
Аэрапорт у Львове|Скнилов
Аэрапорт у Мадрыдзе|барахос
Аэрапорт у Манрэалі|дорваль
Аэрапорт у Петразаводску|бесовец
Аэрапорт зблізку Масквы|внуково
З 1699 гады дзякуючы рэформе Пятра I Расія атрымала новы ...|каляндар
З 18 ст. першы афіцэрскі чын у казачых войсках рускага войска|харунжы
З 1949 – Джакарта|Батавія
З яго Считалией і Вообразилией шматлікія з вас пазнаёміліся ў дзяцінстве|Заходер
З яго карціны “Спакуса” пачалася калекцыя купца Паўла Третьякова|Шильдер
З якога боку на яго ні паглядзі, а ўсё падобны на індукцыйны паскаральнік|бэтатрон
З якім футбольным клубам злучана жыццё гульца і арганізатара Мікалая Старостина|Спартак
З латыні гэта – перасоўванне, перасяленне. Але гэта слова ўжываюць у адносінах да жывёл, а ў адносінах да людзей да гэтага слова дадаюць прыстаўкі. Што гэта за слова?|міграцыя
З морквай замест носа|снегавік
З чым асацыюецца феерверк|петарда
З гэтага слова пачыналіся рознага роду звароту да савецкага народа|таварышы
С/г адмысловасць|жывёлагадовец
