Сістэма безнаяўнасць. разлікаў з залікам узаемных абавязанняў|клірынг
Сістэма галосных фанем дадзенай мовы, іх прыкметы і адносіны|вакалізм
Сістэма запісу шахматнай партыі|натацыя
Сістэма каналаў і паражнін ва ўнутраным вуху|лабірынт
Сістэма мерапрыемстваў для прадухілення банкруцтва|санацыя
Сістэма мерапрыемстваў, пры правядзенні якіх на судне паднімаецца жоўты сцяг|карантын
Сістэма ўспадкоўвання маёмасці малодшым у сям'і|минорат
Сістэма ўспадкоўвання, пры якой нерухомая маёмасць пераходзіць непадзельна да старэйшага сына ці да старэйшага ў родзе|маярат
Сістэма нямецкага аўтамата|шмайсер
Сістэма прававых органаў, адмыслоўцы якіх сведчаць здзяйсненне ўгод, складанне завяшчанняў, дамоў|натарыят
Сістэма тэлебачання|месекам
Сістэма фізічных практыкаванняў|рытміка
Сістэматызаваны выклад рэлігійнага вучэння|тэалогія
Сістэматызаваны збор звестак, які складаецца перыядычна|кадастр
Сістэматыка, катэгорыя ў біялогіі|вариетет
Сістэматыка, катэгорыя ў біялогіі|падклас
Сістэматыка, катэгорыя ў біялогіі|падатрад
Сістэматыка, катэгорыя ў біялогіі|царства
Сістэмы арт. прылад з уніфікаваны. лафетам пад разн. ствалы|дуплекс
Сібірская страва з цеста з мясным начыннем|пяльмені
Сібірская і азіяцкая бязрогая горная парнакапытная жывёла|кабарга
Сібірская назва яравой іржы|паданка
Сібірскі горад, дзе жыве пісьменнік Валянцін Распуцін|Іркуцк
Цыгарэты з ментолом|Салем
Сігнал SОS пустога страўніка|буркатанне
Сігнальная прылада ў выглядзе рэйкі на слупе|семафор
Сігнальная прылада для спецавтомобиля на гутарковай мове|мігцелка
Сядушка на чатырох ножках без спінкі на аднаго чалавека|зэдлік
Сядушка з адтулінай пасярэдзіне ў прыбіральні|стульчак
Сядушка для вандроўніка|валізка
Сядушка з дрэва|лаўка
Прысутны на шыі ў іншых|дармаед
Сіла дзеяння аднаго цела на паверхню іншага|ціск
Силикат, які змяшчае жалеза і магній|піраксен
Моцная працяглая стральба са шматлікіх прылад|кананада
Моцная электралямпа, што ўжываецца для святлолячэння|солюкс
Моцны, добра плывучы сабака, выкарыстоўваная для выратавання тапельцаў|вадалаз
Моцна расцяжная адзінка часу, традыцыйна якая фігуруе ў просьбах трохі пачакаць|секунда
Моцна што награваецца жалезная скрынка ў кухоннай пліце|духоўка
Моцна накрухмаленая ці прасякнутая адмысловым складам баваўняная тканіна|каленкор
Моцна пахкая трапічная расліна з кветкай мудрагелістай формы|архідэя
Сильнодейств. болеутоляющ. і снатворнае рэчыва|наркотык
Моцнадзейны наркотык, выпрацоўваемы з опіумнага маку|гераін
Моцны сухі вецер у Міжземнамор'е|сірока
Моцны спалох|перапуд
Моцны імпэтны вецер|шквал
Знак цела Хрыста ў праваслаўных церк. абрадах, круглая белая перапечка|просвіра
Знак цела Хрыста ў праваслаўных церк. абрадах, круглая белая перапечка|прасфора
Сімвалічны запіс складу і будынкі хімічных рэчываў|формула
Сімвалічнае пазначэнне пекла, пагібелі грэшнікаў|геенна
Сімвалічны атрыбут Украіны|трызубец
Сімвалічны атрыбут бога мораў|трызубец
Знакі каралеўскай улады (карона і інш.), а таксама прывілеі манарха на атрыманне шэрагу прыбыткаў|рэгаліі
Сімптом, адрозніць. чорта|прыкмета
Сінонім арабы|сарацыны
Сінонім абстрактнасць|адцягненасць
Сінонім аўтастрада|аўтамагістраль
Сінонім айсбаль|ледасек
Сінонім алідада|кутамер
Сінонім аналы|летапіс
Сінонім апория|праблема
Сінонім Сарматха|эверэст
Сінонім адпаведна|адэкватна
Сінонім салдатаў|радавы
Сінонім торба|клунак
Сінонім сведка, глядач|відавочнік
Сінонім сістэматыка|парадак
Сінонім лягчанец|пакладанец
Сінонім быдла|жывёла
Сінонім скнара|скнара
Сінонім слова харакіры на мове культурн. класа Японіі|сэппуку
Сінонім бліскавіца|паланіца
Сінонім спадарожнік|сатэліт
Сінонім шыўка|сцяжынка
Сінонім будынак|пабудова
Сінонім халадзец|квашаніна
Сінонім неспадзеўка|падарунак
Сінонім пратока|пратока
Сінонім непаседа|непаседа
Сінонім ажына|ажына
Сінонім аблога|блакада
Сінонім абразіць|пакрыўдзіць
Сінонім гарлапаніць|крычаць
Сінонім абеліск, манумент|помнік
Сінонім зарок|абяцанне
Сінонім узор, правобраз|прататып
Сінонім агляд (напр., навін)|панарама
Сінонім пяротрус|праверка
Сінонім апора, цвярдыня (перен.)|курціна
Сінонім ахайнасць, парадак|чысціня
Сінонім адступ|ретирада
Сінонім адрывіста (муз.)|стаката
Сінонім відавочнік|глядач
Сінонім радар|лакатар
Сінонім радасць|весялосць
Сінонім дазвол|ліцэнзія
Сінонім выведка|шпіянаж
Сінонім разгул, оргія|вэрхал
Сінонім разгалашэнне, вядомасць|агалоска
Сінонім разнастайнасць|адрозненне
Сінонім рэверанс (устар.)|кніксэн
Сінонім Рокки|сталлоне
Сінонім малюнак|малюначак
Сінонім Рэмба|сталлоне
Сінонім шэраг, чарада (напр., літаратурных выяў, малюнкаў, прадметаў у калекцыі)|галерэя
Сінонім квашаніна|заліўное
Сінонім карак|карак
Сінонім адвага|адвага
Сінонім умова|дамова
Сінонім забойства (кут. жарг.)|мокруха
Сінонім поспех|шчасце
Сінонім умацаванне, хованка|цвярдыня
Сінонім умацаванне, хованка|сховішча
Сінонім ухіл|крутасць
Сінонім уключына (замочн.)|свідравіна
Сінонім памерлы|нябожчык
Сінонім маліць|прасіць
Сінонім спадзяванне|надзея
Сінонім вучань|які вучыцца
Сінонім Перайначванне, разнавіднасць|варыянт
Сінонім Геракл|Геркулес
Сінонім Перемысль|пшемысль
Сінонім барабаншчык|ударнік
Сінонім балака|гаварун
Сінонім турбота|трывога
Сінонім лайдак|дармаед
Сінонім бездань|прорва
Сінонім бязмоўе|маўчанне
Сінонім бой|бітва
Сінонім шлюб|жаніцьба
Сінонім бронтозавр|апатазаўр
Сінонім дыямент|дыямент
Сінонім папернік|партманетка
Сінонім биллиард, лік|мільярд
Сінонім балазе|шчасце
Сінонім дзякую|дзякуй
Сінонім асалода, прыемны стан|пяшчота
Сінонім мінуўшчына|мінулае
Сінонім варагі|норманы
Сінонім вершнік|наезнік
Сінонім усё|максімум
Сінонім весялосць|радасць
Сінонім весялун, гаварун|балака
Сінонім вестка|вестка
Сінонім веранда|тэраса
Сінонім версія|варыянт
Сінонім волат, волат|волат
Сінонім венік|метелка
Сінонім васьмірадкоўе|трыялет
Сінонім задавака|задавака
Сінонім крадзеж|крадзеж
Сінонім уздзеянне|уплыў
Сінонім чараўнік|чарадзей
Сінонім пытанне|праблема
Сінонім варожасць|злосць
Сінонім кручэнне|ратацыя
Сінонім увага|цікавасць
Сінонім святліца|пакой
Сінонім урвіцеля, атрыманы з прозвішча жорсткага маскоўскага обер-полицмейстера|архаравец
Сінонім гіпапатам|бегемот
Сінонім дамба|плаціна
Сінонім дзеянне, акт|учынак
Сінонім дэпеша|пасланне
Сінонім дэпартацыя|выгнанне
Сінонім прыбытак|прыбытак
Сінонім старажытнасць|старасць
Сінонім двубой|паядынак
Сінонім дваістасць|дуалізм
Сінонім дзіцё|дзіця
Сінонім зародак|бластула
Сінонім зародак|гаструла
Сінонім зародак|эмбрыён
Сінонім клопат|клопаты
Сінонім занядужаць|захварэць
Сінонім калець|мерзнуць
Сінонім ірыгацыя|абрашэнне
Сінонім нераставанне|нераст
Сінонім маёнтак|маёнтак
Сінонім імя, мянушка|назва
Сінонім іншасказанне|алегорыя
Сінонім цікавасць|увага
Сінонім малюначак|малюнак
Сінонім калека|інвалід
Сінонім камікадзэ|смяротнік
Сінонім канава, выбоіна|калдобіна
Сінонім ваганне, дрыгаценне|трапятанне
Сінонім калабарацыяніст|здраднік
Сінонім кансультант|рэферэнт
Сінонім кантроль, выпрабаванне|праверка
Сінонім копія|падробка
Сінонім катлавіна|западзіна
Сінонім кошара|аўчарнік
Сінонім кашалёк|партманетка
Сінонім прыгажосць|хараство
Сінонім крэпасць|цытадэль
Сінонім кизил|свідзіна
Сінонім ключ, крыніца|крыніца
Сінонім клятва|прысяга
Сінонім кніксэн|рэверанс
Сінонім лаотянский, мова Азіі|лаоскі
