Знак жорсткай няўмольнай сілы, якая патрабуе мноствы ахвяр|малох
Знак мастацтва (переносн.)|ліра
Знак кахання, запал|эрас
Знак кахання, запал|эрот
Знак некаторых рэспубалік трэцяга свету|банан
Знак поэтич. натхненні; сузор'е|Пегас
Знак поэтич. натхненні|Пегас
Знак раўніўца ў сусветнай літаратуры|Атэла
Знак свежасці, паветра пасля навальніцы|азон
Знак святасці|німб
Знак святасці|арэол
Знак сямейнага шчасця|хата
Знак саладжавасці|патака
Знак сцэны, тэатра (перен.)|рампа
Знак хрысціянскага культу|крыж
Знак, літара|знак
Знак, які ў матэматыку часта ўжываюць для пазначэння сумы|сігма
Знак; сав. вясляр|знак
Знак|знак
Сімвалічны надпіс, выслоўе. Напр. “Праз цёрне – да зорак”|дэвіз
Знакам гэтай краіны з'яўляецца ружа|Англія
Сіменс у мінус 1|ом
Сіметрычна размешчаныя шэрагі вочак для захоўвання мёда і муры яйкаў у пчол|соты
Сімпатычны слесар з кіно|Афоня
Сімптом “Белай гарачкі”|трызненне
Сімптом раздражнення ўнутраных органаў|крыз
Сімптом землятрусу?|штуршок
Сімптом адзёру|сып
Сімптомы набліжэння прыпадку эпілепсіі, істэрыі (медиц.)|аўра
Симф. паэма Бартока|кошут
Сімфанічная паэма С. Франка|Псіхея
Сімфанічная фантазія А. Глазунова|мора
Сімфонія Бернстайна|каддиш
Синагогальный служка|шамаш
Сінгапурцы завуць гэты занятак сваім нацыянальным баўленнем часу. У сярэднім яны робяць гэта кожная гадзіна. Што ж гэта?|ежа
Сіне-зялёнае багавінне|цианеи
Сінекдаха, эўфемізм, перыфраз|сцежак
Сіненькая шубенка пакрыла ўвесь свет (загадка)|неба
Сіні кіт – блювал, сайдяной кіт – сейвал, сельдяной кіт – фінвал. А хто такі трупны кіт?|нарваў
Сіні кіт – воднае млекопитающее сямействы паласацікаў|блювал
Сіні фрукт з костачкай|зліву
Сіні, сіні, ложившийся на правады (песень.)|шаць
Сініца, якая насяляе па берагах вадаёмаў|рэмез
Синним яр|абрыў
Сінонім “Чырвоны нос”|Мароз
Сінонім Ахілес|Ахилл
Сінонім Вечны горад|Рым
Сінонім Сусвет|космас
Сінонім Конга|Заір
Сінонім Луганда|ганда
Сінонім Месяц|Селена
Сінонім Выява (религиоз.)|абраз
Сінонім Акіянія|Адэлаіда
Сінонім Капрыз, дзівацтва|капрыз
Сінонім Сіменс|мо
Сінонім Жэрдкі|Плеяды
Сінонім абак|лічыльнікі
Сінонім аўтастрада|хайвэй
Сінонім адвакат|юрыст
Сінонім рызыка, запал|запал
Сінонім азбука|алфавіт
Сінонім акрабат|трукач
Сінонім акцёр|артыст
Сінонім алюр|рысь
Сінонім алфавіт|азбука
Сінонім альянс|звяз
Сінонім ангажэмент|найманне
Сінонім трыбуна|амбон
Сінонім артыст|акцёр
Сінонім аспірын|упса
Сінонім асарці|набор
Сінонім ахінея|лухта
Сінонім кірмаш|рынак
Сінонім бэлька, лог|яр
Сінонім баласт|груз
Сінонім бедны|жабрак
Сінонім бессаромны|нахабнік
Сінонім бескарыслівасць|альтруізм
Сінонім біяполе|аўра
Сінонім бізун|пуга
Сінонім дабравест|звон
Сінонім дабрачыннасць?|філантропія
Сінонім духмянасць|водар
Сінонім бляск|ззянне
Сінонім бой, бітва|бітва
Сінонім балван|дундук
Сінонім хвароба|хвароба
Сінонім бонус|зніжка
Сінонім босота (уголовн.)|шпана
Сінонім яма|вір
Сінонім лаянка|лаянка
Сінонім пырскі|крап
Сінонім шугавея|завея
Сінонім быццё|жыццё
Сінонім бюргер|буржуа
Сінонім варыянт|версія
Сінонім угару (традиц. каманда пры пагрузных і т. п. працах)|віра
Сінонім волат|гігант
Сінонім венік|венік
Сінонім вяпрук|кабан
Сінонім вячэра|вячэра
Сінонім глупства|ерась
Сінонім унёсак|выплата
Сінонім уладальнік|гаспадар
Сінонім валодаць|мець
Сінонім уніз (традиц. каманда пры пагрузных і т. п. працах)|майна
Сінонім правадыр|фюрар
Сінонім паветраплавальнік|аэранаўт
Сінонім умілаваная, палюбоўніца|пасія
Сінонім вазніца|кучар
Сінонім ваяр|баец
Сінонім вайна, бітва (устар.)|лаянка
Сінонім войска|войска
Сінонім натхненне|уздым
Сінонім лямант|крык
Сінонім уваскрашэнне (мёд.)?|рэанімацыя
Сінонім хлусіць|маніць
Сінонім лекар|доктар
Сінонім выснова, вынік|вынік
Сінонім выгада, карысць|карысць
Сінонім выгада|карысць
Сінонім вышыня|высь
Сінонім высь|вышыня
Сінонім гам|гоман
Сінонім гам|шум
Сінонім гарнітур|набор
Сінонім вачэй|вока
Сінонім вачніца (мёд.)|арбіта
Сінонім глетчар|ляднік
Сінонім угодкі|юбілей
Сінонім урвіцеля, “атрыманы” з прозвішча жорсткага маскоўскага обер-полицмейстера|архаравец
Сінонім гонар|пыха
Сінонім гора, бяда|ліха
Сінонім горка|узгорак
Сінонім дзяржава|краіна
Сінонім мяжа|мяжа
Сінонім грот|пячора
Сінонім груда|куча
Сінонім сум|смутак
Сінонім здольнасць|талент
Сінонім рухавік|матор
Сінонім палац|палац
Сінонім справа|дасье
Сінонім зараніца|світанак
Сінонім дзясятак (устар.)|дэкада
Сінонім дэталізацыя|аналіз
Сінонім дзеці|дзеці
Сінонім децимед|ансамбль
Сінонім дынастыя|род
Сінонім дыспут?|спрэчка
Сінонім дазнанне|допыт
Сінонім дока|знаўца
Сінонім дока|умелец
Сінонім пасада|месца
Сінонім даліна|дол
Сінонім даляры (разг.)|баксы
Сінонім дзель|лёс
Сінонім дзель|частка
Сінонім дарога (устар.)|шлях
Сінонім старажытнасць|антычнасць
Сінонім дума|думка
Сінонім дур|блазнота
Сінонім дымку|мга
Сінонім д'ябал|сатана
Сінонім д'ябал|чорт
Сінонім ёсць|есці
Сінонім жаргон, слэнг|арго
Сінонім жаргон|слэнг
Сінонім збан|гарлач
Сінонім жыццё|быццё
Сінонім жулік?|злодзей
Сінонім забава|пацеха
Сінонім завяшчанне|запавет
Сінонім заггас|эканом
Сінонім карак|карак
Сінонім запал, удаласць|кураж
Сінонім запал|запал
Сінонім зазор|шчыліна
Сінонім заход|заход
Сінонім заслона|запавеса
Сінонім замкне, спыненне|адмена
Сінонім світанак|узыход
Сінонім засуха|суш
Сінонім глухмень|глухмень
Сінонім гуказдымальнік|тонарм
Сінонім здравіца|тост
Сінонім зелле, атрута|яд
Сінонім зямля|суша
Сінонім земнаводная, агульная назва|амфібія
Сінонім земнаводныя, агульная назва (адказ у мн. ч.)|амфібіі
Сінонім зігзаг|залом
Сінонім сцяг|сцяг
Сінонім значэнне|сэнс
Сінонім спёка|спякота
Сінонім кліч|заклік
Сінонім няволя|хіліць
Сінонім ідэал|мэта
Сінонім ідал|кумір
Сінонім вестка|вестка
Сінонім выслоўе|цытата
