Сінонім імідж|выява
Сінонім імя, назва|мянушка
Сінонім інвалід|калека
Сінонім індывід|асоба
Сінонім манах|манах
Сінонім прылада|прылада
Сінонім шуканне|пошук
Сінонім праўда|праўда
Сінонім кат|садыст
Сінонім вынік|выснова
Сінонім кадр|здымак
Сінонім камін|агмень
Сінонім канон|норма
Сінонім капітал|грошы
Сінонім карма|лёс
Сінонім кашпо|ваза
Сінонім кіназорка|дзівы
Сінонім кінакампанія|студыя
Сінонім заклік|кліч
Сінонім клятва|зарок
Сінонім пуга|пуга
Сінонім скура (біёлаг.)|дзерма
Сінонім біць|біць
Сінонім калчан|джерид
Сінонім кон (рызыкоўнае)|стаўка
Сінонім кандэнсат|раса
Сінонім капальні|рудня
Сінонім касманаўт|астранаўт
Сінонім клунак|торба
Сінонім фарба|колер
Сінонім чырванець|пунсавець
Сінонім прытулак, сховішча|прымуць
Сінонім прытулак|дах
Сінонім кавадла|молат
Сінонім кучаравіцца|віцца
Сінонім кузен|брат
Сінонім куча|груда
Сінонім кучар|фурман
Сінонім есці|ёсць
Сінонім ладан|фіміям
Сінонім лапці|чуні
Сінонім маніць|хлусіць
Сінонім лёгкі падстрэшак|тэнт
Сінонім аладка|аладка
Сінонім летапіс|аналы
Сінонім ілгун, ашуканец|ілгун
Сінонім ліліпут|карлік
Сінонім лінія|чорта
Сінонім ліпа, зман|фальш
Сінонім літара|літара
Сінонім ліха|бяда
Сінонім ліха|гора
Сінонім лоб|чало
Плоскодонная лінейна выцягнутая, безрусловая ці з зачаткавымі рэчышчамі лагчына, утвораная ў выніку сумеснай дзейнасці дажджавых і адталых вод і спаўзанні грунта, які запаўняе дно даліны|делль
Сінонім глянец|глянец
Сінонім лысіна|лысіна
Сінонім людаед|антрапафаг
Сінонім людаедства|антрапафагія
Сінонім лютня|саз
Сінонім маўр|Атэла
Сінонім чараўнік|вядзьмак
Сінонім майна|уніз
Сінонім перакупшчык (устаревш.)|маклер
Сінонім масліна|аліва
Сінонім матадор|эспада
Сінонім матэрыя (портняжн.)|тканіна
Сінонім матрос|марак
Сінонім імгненне|імгненне
Сінонім метелка|венік
Сінонім мзга, смуга|імга
Сінонім минисамолет|авіетка
Сінонім моднік, франт|франт
Сінонім гаворка|слых
Сінонім матыў|напеў
Сінонім моц|сіла
Сінонім муж|супруг
Сінонім мускул|цягліца
Сінонім смецце|адкід
Сінонім думка|дума
Сінонім мысленне|логіка
Сінонім цягліца|мускул
Сінонім навык|досвед
Сінонім узнагарода, плата|хабар
Сінонім найманне|ангажэмент
Сінонім назва, мянушка|імя
Сінонім напад|агрэсія
Сінонім убор|адзежа
Сінонім націск|напор
Сінонім начальнік, заступнік|патрон
Сінонім начальнік|бос
Сінонім нашатыр|аміяк
Сінонім небасхіл|неба
Сінонім невук|прафан
Сінонім нявольнік, халоп|раб
Сінонім недахоп|шлюб
Сінонім няшчырасць, прытворства|фальш
Сінонім нелогичность|алагізм
Сінонім нянавісць|антыпатыя
Сінонім блытаніна|хаос
Сінонім нефармал|панк
Сінонім ніва (с/г)|ралля
Сінонім набілітэт|арыстакратыя
Сінонім навізна|навіна
Сінонім ножовка|піла
Сінонім ноша, паклажа|груз
Сінонім нуль, нулявы (ангел.)|зеро
Сінонім абаянне, зачараванне|шарм
Сінонім ахаваў|кудмень
Сінонім абяцанне|зарок
Сінонім ашуканец|жулік
Сінонім абмен|бартар
Сінонім нюх|нюх
Сінонім абарона|абарона
Сінонім обусловливание|ангажыраванне
Сінонім пяротрус (жарг.)|шмон
Сінонім авал|эліпс
Сінонім аўчарнік|кошара
Сінонім абмежавальнік|стопар
Сінонім ласка|паслуга
Сінонім аклад (зарплата)|стаўка
Сінонім кайданы|ланцугі
Сінонім кудмень|ахаваў
Сінонім вір|яма
Сінонім промах|памылка
Сінонім апора, апора|цвержа
Сінонім досвед|навык
Сінонім арала|саха
Сінонім абрашэнне|паліванне
Сінонім падстава, чыннік|права
Сінонім жартаўнік|жартаўнік
Сінонім вось|вал
Сінонім водбліск|водбліск
Сінонім адкід|смецце
Сінонім водгалас, рэха|водгук
Сінонім айчына|радзіма
Сінонім водгук, характарыстыка|атэстацыя
Сінонім водмель|слоік
Сінонім водмель|котка
Сінонім водбліск?|водбліск
Сінонім адступ|адкат
Сінонім адступ|адыход
Сінонім ахова|варта
Сінонім агмень|камін
Сінонім абрыс|контур
Сінонім панарама|выгляд
Сінонім парапет|парэнчы
Сінонім лунанне|палёт
Сінонім хлопец|юнак
Сінонім закладу|спрэчка
Сінонім пекла|пекла
Сінонім персона|асоба
Сінонім смутак|сум
Сінонім пілот|лётчык
Сінонім ежа, ежа|ежа
Сінонім плата (старорусское)|хабар
Сінонім лысіна|лысіна
Сінонім шэльма, ашуканец|шэльма
Сінонім звычка|манера
Сінонім сапраўднасць, раўназначнасць|аўтэнтычнасць
Сінонім падабенства, падабенства?|гамалогія
Сінонім падпорка|упор
Сінонім цягнік|склад
Сінонім паездка|ваяж
Сінонім прыхільнік|фан
Сінонім супакой|адпачынак
Сінонім полісемія?|шматзначнасць
Сінонім карысць, карысць?|толк
Сінонім маёнтак|маёнтак
Сінонім памагаты|асістэнт
Сінонім панос (мёд.)|дыярэя
Сінонім апека, сыход|клопат
Сінонім порт|гавань
Сінонім портер|піва
Сінонім даручальнік|гарант
Сінонім наведвальнік|госць
Сінонім пасроднік|куртье
Сінонім нашчадак|унук
Сінонім глеба|грунт
Сінонім папраўка|рамонт
Сінонім паэзія, вершы|вершы
Сінонім паэт (стары.)|паэт
Сінонім праўда|праўда
Сінонім праведнік|аскет
Сінонім прашчур|продак
Сінонім здраднік, здраднік|юда
Сінонім продак|прашчур
Сінонім засцярога|асцярога
Сінонім засцерагальнік (суеверн.)|кудмень
Сінонім набліжэнне|апраксімацыя
Сінонім прыступ|штурм
Сінонім прысяга|клятва
Сінонім праблема|пытанне
Сінонім праверка, агляд|рэйд
Сінонім праверка|зверка
Сінонім правадыр|гід
Сінонім прадавец (штодзённае)|гандляр
Сінонім праект|план
Сінонім здарэнне|выпадак
Сінонім карысць|карысць
Сінонім супернік, непрыяцель|вораг
