Сінонім працэс, праца|справа
Сінонім скачок|скок
Сінонім псеўданім|астроним
Сінонім пустослов, балбатун|фразёр
Сінонім пустослов|балбатун
Сінонім пустэча|вакуум
Сінонім шлях|дарога
Сінонім пушку|прылада
Сінонім пятикнижие|тора
Сінонім праца, занятак|праца
Сінонім рабства, няволя|няволя
Сінонім раўнавага, ураўнаважванне|баланс
Антонім разборка|зборка
Сінонім размежаванне|раскол
Сінонім гіра|гіра
Сінонім разбуральнік|варвар
Сінонім разрад|ранг
Сінонім розум, интелект|розум
Сінонім рай|эдэм
Сінонім ранг|разрад
Сінонім распараджэнне?|загад
Сінонім дзеці|дзеці
Сінонім рэгрэс|спад
Сінонім рэестр|вопіс
Сінонім рэпутацыя, імідж|рэнамэ
Сінонім маляваць|пісаць
Сінонім малюнак|плакат
Сінонім крыніца|ключ
Сінонім рудня|збірай
Сінонім русак|заяц
Сінонім рынак|кірмаш
Сінонім радавой|салдат
Сінонім самобийство|суіцыд
Сінонім самалёт|авіялайнер
Сінонім самалётакіраванне|аэранавігацыя
Сінонім самалюбства, ганарлівасць, пыха|амбітнасць
Сінонім самаспаленне|аўтадафэ
Сінонім сафары|паляванне
Сінонім свінчатка|кастэт
Сінонім воля|воля
Сінонім сувязіст|радыст
Сінонім сераль|гарэм
Сінонім сігнал|сірэна
Сінонім сіняк (разг.)|фингал
Сінонім скандаліст|буян
Сінонім пажыткі, пажыткі|рэчы
Сінонім схіл|адхон
Сінонім скруха|жалоба
Сінонім скаціна|быдла
Сінонім нуда|маркота
Сінонім скульптура|статуя
Сінонім слэнг|жаргон
Сінонім слоў пахіл, адхон, схіл|скос
Сінонім слова “жываглот”|вывергнуў
Сінонім смурод|смурод
Сінонім салдатаў|баец
Сінонім соус|кетчуп
Сінонім спекулянт|гандляр
Сінонім пыха|гонар
Сінонім спор|дыспут
Сінонім спосаб|метад
Сінонім спосаб|метаду
Сінонім бітва (устаревш.)|сеча
Сінонім бітва|бой
Сінонім стары|дзед
Сінонім старызна|хлам
Сінонім слуп (электрич.)|апора
Сінонім прыпар (с/г)|уборка
Сінонім страх, боязь|трапятанне
Сінонім сцюжа?|холад
Сінонім сорам|ганьба
Сінонім лёс|карма
Сінонім торба|куфар
Сінонім мужа|жонка
Сінонім суш|засуха
Сінонім шчасце, дабро|балазе
Сінонім шчасце, поспех|удача
Сінонім таямніца|сакрэт
Сінонім цвержа|апора
Сінонім тканіна, палатно, цаліна|навіна
Сінонім нуда, засмучэнне|маркота
Сінонім траншэя|канава
Сінонім трапеза|абед
Сінонім марнаванне, выдаткі, выдаткі|выдатак
Сінонім жалоба|скруха
Сінонім трыа|тэрцэт
Сінонім трыўмф|перамога
Сінонім сцяжынка, сцежка|шыўка
Сінонім праца|праца
Сінонім турнэпс|рэпа
Сінонім перакананне|погляд
Сінонім задавальненне, радасць|уцеха
Сінонім удушша|асфіксія
Сінонім паказальнік|індэкс
Сінонім розум|розум
Сінонім выплата|унёсак
Сінонім упса|аспірын
Сінонім ураган|бура
Сінонім поспех, перамога|трыўмф
Сінонім поспех, шчасце|поспех
Сінонім уступ, умацаванне|эскарп
Сінонім змарыцца|стаміцца
Сінонім заляцанне, клопаты|клопат
Сінонім пагаршэнне, паслабленне|заняпад
Сінонім шкода|шкода
Сінонім фальш, зман|ліпа
Сінонім фіякр|экіпаж
Сінонім фіяска|правал
Сінонім фізіяномія|твар
Сінонім філігрань|скань
Сінонім філосаф|логік
Сінонім фінал|канец
Сінонім сцяг, сцяг|сцяг
Сінонім фужэр|куфель
Сінонім фурункул|скула
Сінонім маркота|нуда
Сінонім хаос, блытаніна|вэрхал
Сінонім херувім|анёл
Сінонім халупа-развалюха|халупа
Сінонім хітрасць, ашуканства|зман
Сінонім хлам|старызна
Сінонім дубец, пуга|пуга
Сінонім хол|зала
Сінонім узгорак|горка
Сінонім халасцяк-дамасед|абібок
Сінонім палац|палац
Сінонім ланцуга|кайданы
Сінонім чэзлы|кволы
Сінонім чало|лоб
Сінонім чын, ранг|сан
Сінонім пачвара, вырадак|монстар
Сінонім чуні|лапці
Сінонім лухта|ахінея
Сінонім шаблон|штамп
Сінонім шолах|шоргат
Сінонім шына (аўта)|пахіл
Сінонім шышак, шалом|шлем
Сінонім шоргат|шолах
Сінонім шпалеры|шпалеры
Сінонім шпіён|шпік
Сінонім штамп|шаблон
Сінонім блазан, блазан|арлекін
Сінонім жартаўнік|жартаўнік
Сінонім франт|франт
Сінонім щипач|злодзей
Сінонім аксамітнік|амарант
Сінонім эдэм|рай
Сінонім эксперымент|досвед
Сінонім экспертыза|аўдыт
Сінонім эліпс|авал
Сінонім эталон|мерка
Сінонім юстыцыя|феміда
Сінонім яд|зелле
Сінонім яд|атрута
Сінонім ял|шлюпка
Сінонім лютасць|гнеў
Сінонім яшчарка|ящерка
Сінонімы маргиналий, ліхтарык|глосса
Синтаксич. канструкцыя, якая дапускае розныя тлумачэнні|амфіболія
Синтетич. валакно|амід
Синтетич. валакно|дакрон
Синтетич. карунд ці шпинель з александритовым эфектам|александрынаў
Синтетич. тканіна|вистра
Синтетич. тканіна|капрон
Синтетич. фарбавальнік, раней здабываўся з каранёў марены|алізарын
Сінтэтычная тканіна|нейлон
Сінтэтычны заменнік цукру|ксилит
Сінтэтычны карунд|адамит
Сінтэтычны матэрыял для пакрыцця бегавых дарожак|тартан
Сінтэтычны ниобат літыя, использ. для імітацыі дыямента|астрилит
Сінтэтычны ювелірны матэрыял, титанат стронцыя|диагем
Сінтэтычнае валакно|акрылан
Сінтэтычнае валакно|анід
Сінтэтычнае валакно|лаўсан
Сіньёр памідораў (сельскохоз.)|тамат
Синюшная афарбоўка канечнасцяў пры наруш. кровазвароты|акроцианоз
Синюшное афарбоўванне скуры і слізістых абалонак пры недастатковым насычэнні крыві кіслародам|цыяноз
Сіняк пад вокам (штодзённае)|ліхтар
Сіняк, атрыманы ў інтымнай сутычцы|засмокт
Сіняя фарба|азур
Сіплыя гукі|сипота
Сірыйская мухафаза|Идлиб
Сірыйская спартоўка (семиборье), чэмпіёнка свету|Шуа
Сірыйскі касманаўт|Фарис
Сірыя|САР
Сіроп на аснове міндаля|орджит
Сістэма вакуоляў расліннай клеткі|вакуом
Сістэма велічынь, прынятых для вымярэння той ці іншай велічыні|шкала
Сістэма гледжанняў якога-небудзь мысляра|вучэнне
Сістэма госуд. прылады|лад
Сістэма дзяржаўнай ці грамадскай прылады|лад
Сістэма для пуску і прыпынкі прылад|аўтааператар
Сістэма чыгуначных шляхоў з ухілам для сартавання вагонаў|горка
Сістэма гукаў і слоў, з дапамогай якой людзі выяўляюць свае думкі|мова
Сістэма ведаў пра заканамернасці развіцця прыроды, грамадствы і мысленні|навука
Сістэма ведаў пра прыроду, грамадстве|навука
Сістэма ведаў пра што-небудзь|навука
Сістэма вымярэння|сі
Сістэма канаў і труб для асушкі глебы|дрэнаж
Сістэма кантор і агентаў манаполій пры заканадаўчых органах ЗША|лобі
